4	4	4	4	4	4
4	5	5	0	0	4
4	5	6	1	0	4
4	5	7	8	1	4
4	5	0	5	0	4
4	6	0	8	1	4
4	2	2	2	2	4
4	3	3	2	9	4
4	4	4	3	3	4
4	4	4	4	4	4
